XXXXXXXXXXXXXXXXXXXXX
X.................XFX
X.XXXXXXXXXXX.XXXXX.X
X.X.........X.....X.X
X.XXXXXXX.X.XXXXX.X.X
X.X.....X.X.....X...X
X.X.XXX.XXXXX.X.XXXXX
X...X.X.....X.X.....X
XXXXX.XXXXX.X.X.XXX.X
X.....X...X.X.X.X.X.X
XXX.X.X.X.X.XXX.X.X.X
X...X.X.X.X.....X.X.X
X.XXX.X.X.XXXXXXX.X.X
X.X...X.X...X.......X
X.XXXXX.XXX.X.XXXXXXX
X.....X...X...X...X.X
X.XXX.XXX.XXXXX.X.X.X
X.X.X...X...X...X.X.X
X.X.XXX.XXX.X.XXX.X.X
XI....X.......X.....X
XXXXXXXXXXXXXXXXXXXXX
