XXXXXXXXXXXXXXXXXXXXX
X..................FX
X...................X
X...................X
X...................X
X...................X
X...................X
X...................X
X...................X
X...................X
X...................X
X...................X
X...................X
X...................X
X...................X
X...................X
X...................X
X...................X
X...................X
XI...X..............X
XXXXXXXXXXXXXXXXXXXXX
