U...........
............
............
............
............
............
............
............
...........P
..P...T...P.
.U..P....dO.
.........T..
